#一简
啊	a	
不	b	10
吧	b	5
次	c	
的	d	
而	e	
发	f	
个	g	10
感觉	g	5
和	h	
出	i	
就	j	10
觉得	j	5
可	k	10
可以	k	5
了	l	
没	m	10
没有	m	5
你	n	
哦	o	
平	p	
去	q	
人	r	
三	s	
他	t	
是	u	
这	v	
我	w	
下	x	
一	y	10
又	y	5
在	z	10
自己	z	5
# 二码二字
啊对	ad	
按键	aj	
安排	ap	
安全	aq	
艾特	at	
安装	av	
哎呀	ay	
并不	bb	
不但	bd	
不怕	bp	
并且	bq	
不如	br	
不是	bs	
比特	bt	
标准	bv	
并未	bw	
菜单	cd	
聪明	cm	
才能	cn	
此前	cq	
从头	ct	
错误	cw	
才行	cx	
参与	cy	
存在	cz	
到底	dd	
地方	df	10
对付	df	5
电脑	dn	
动态	dt	
而不	eb	
二次	ec	
而当	ed	
而非	ef	
而后	eh	
而况	ek	
而来	el	
恶评	ep	
而且	eq	
二三	es	
儿童	et	
而是	eu	
而这	ev	
而我	ew	
恶心	ex	
而已	ey	
儿子	ez	
讽刺	fc	
反对	fd	
反而	fe	
非常	fi	
飞快	fk	
分离	fl	
繁忙	fm	
烦恼	fn	
分配	fp	
放弃	fq	
烦人	fr	
发送	fs	
发帖	ft	
反正	fv	
范围	fw	
发现	fx	
反应	fy	
刚才	gc	
过程	gi	
干嘛	gm	
功能	gn	
过去	gq	
共同	gt	
更新	gx	
缓存	hc	
何尝	hi	
后面	hm	
还能	hn	
好奇	hq	
话题	ht	
好像	hx	
出错	ic	
重码	im	
常年	in	
重启	iq	
冲突	it	
成为	iw	
程序	ix	
创作	iz	
骄傲	ja	
句柄	jb	10
脚本	jb	5
进而	je	
积分	jf	
结果	jg	
计划	jh	
解决	jj	
接口	jk	
经历	jl	
矩阵	jv	
讲座	jz	
课程	ki	
科目	km	
可能	kn	
开启	kq	
开通	kt	
科学	kx	
浪费	lf	
目的	md	
冒泡	mp	
默认	mr	
貌似	ms	
明天	mt	
命中	mv	
末尾	mw	
牛逼	nb	
哪怕	np	
内外	nw	
片段	pd	
配额	pe	10
普洱	pe	5
抛弃	pq	
骗人	pr	
配送	ps	
平台	pt	
配置	pv	
品味	pw	
亲爱	qa	
全部	qb	
全额	qe	
区分	qf	
全国	qg	
切换	qh	
全局	qj	
情况	qk	
起来	ql	
其中	qv	
圈子	qz	
热爱	ra	
如此	rc	
认得	rd	
如果	rg	
日历	rl	
人们	rm	
容纳	rn	
日期	rq	
如同	rt	
认为	rw	
如下	rx	
容易	ry	
仍在	rz	
算错	sc	
速度	sd	
什么	sm	
肆虐	sn	
索取	sq	
⭐️	st	
所谓	sw	
思想	sx	
所以	sy	
私自	sz	
听到	td	
突发	tf	
太难	tn	
天气	tq	
天天	tt	
台湾	tw	
手册	uc	
说明	um	
少年	un	10
少女	un	5
事情	uq	
是啥	us	
试图	ut	
实现	ux	
至此	vc	
这么	vm	
只能	vn	
之前	vq	
状态	vt	
这下	vx	
这样	vy	
微博	wb	
卧槽	wc	
我的	wd	
万恶	we	
完成	wi	
我们	wm	
万能	wn	
网盘	wp	
完全	wq	
微软	wr	
为啥	ws	
问题	wt	
为止	wv	
呜呜	ww	10
微微	ww	
微信	wx	
我也	wy	
西安	xa	
想必	xb	
邪恶	xe	
想法	xf	
修改	xg	
喜欢	xh	
新建	xj	
辛苦	xk	
下来	xl	
系统	xt	
性质	xv	
现在	xz	
因此	yc	
一定	yd	10
有点	yd	5
一分	yf	
一个	yg	10
应该	yg	5
以来	yl	
要么	ym	
与其	yq	
一直	yv	
因为	yw	10
以为	yw	5
一下	yx	
再次	zc	
自动	zd	
怎么	zm	
怎能	zn	
增强	zq	
昨天	zt	
作为	zw	
在线	zx	
怎样	zy	
# 三码简(只适合默认的自然码+自然辅)
啊啊啊	aaa
啊对对	add
奥地利	adl
奥达曼	adm
按规定	agd
爱好者	ahv
安静的	ajd
安了个	alg
阿喽哈	alh
爱丽丝	als
安乐窝	alw
安全带	aqd
安全裤	aqk
奥特曼	atm
挨着的	avd
爱学习	axx
哎呦呵	ayh
不安全	baq
不不不	bbb
比比看	bbk
比不了	bbl
白帮忙	bbm
并不能	bbn
抱不平	bbp
并不是	bbu
憋不住	bbv
拜把子	bbz
不存在	bcz
不对啊	bda
不得不	bdb
不动点	bdd
半道儿	bde
贝多芬	bdf
白大褂	bdg
本地化	bdh
不对称	bdi
不对劲	bdj
不得了	bdl
帮倒忙	bdm
不定期	bdq
班得瑞	bdr
被打死	bds
半导体	bdt
表达式	bdu
不倒翁	bdw
不动心	bdx
不但要	bdy
巴尔干	beg
北二环	beh
板儿车	bei
白垩纪	bej
波尔卡	bek
包二奶	ben
不二心	bex
避风港	bfg
百分率	bfl
捕风瓶	bfp
播放器	bfq
比方说	bfu
暴风雪	bfx
并购案	bga
冰棍儿	bge
办公楼	bgl
不给你	bgn
不公平	bgp
办公区	bgq
被告人	bgr
办公桌	bgv
不管用	bgy
不会啊	bha
报户口	bhk
不合理	bhl
不好弄	bhn
变换器	bhq
不和谐	bhx
不会再	bhz
不成立	bil
笔记本	bjb
不健康	bjk
比基尼	bjn
编辑器	bjq
北京市	bju
绊脚石	bju
伯克利	bkl
不可能	bkn
不客气	bkq
不开心	bkx
暴露出	bli
八路军	blj
玻璃瓶	blp
柏拉图	blt
玻璃珠	blv
波浪形	blx
半拉子	blz
不能啊	bna
不能看	bnk
不能有	bny
不能在	bnz
保平安	bpa
不平等	bpd
变频管	bpg
白平衡	bph
不平常	bpi
被骗了	bpl
不骗你	bpn
不匹配	bpp
变频器	bpq
白皮书	bpu
不排除	bpv
表情包	bqb
白求恩	bqe
版权法	bqf
版权归	bqg
搬迁户	bqh
不清楚	bqi
闭区间	bqj
冰淇淋	bql
并且能	bqn
并且是	bqu
标签页	bqy
百日草	brc
不认得	brd
白热化	brh
别人家	brj
被认可	brk
不入流	brl
白日梦	brm
不然呢	brn
哺乳期	brq
比如说	bru
不认为	brw
不如意	bry
比萨饼	bsb
波塞冬	bsd
贝赛尔	bse
变速杆	bsg
变色龙	bsl
不是吗	bsm
不算事	bsu
变态啊	bta
比特币	btb
不停地	btd
不太好	bth
不痛快	btk
别提了	btl
不太行	btx
不统一	bty
不是吧	bub
不舍得	bud
不是个	bug
不适合	buh
不少了	bul
半衰期	buq
编者按	bva
标准版	bvb
不知道	bvd
标识符	bvf
把这个	bvg
标准化	bvh
不支持	bvi
标准库	bvk
备注栏	bvl
标志牌	bvp
保质期	bvq
班主任	bvr
拜占庭	bvt
本质上	bvu
标志着	bvv
不指望	bvw
标志性	bvx
不至于	bvy
保温杯	bwb
不稳定	bwd
鲍威尔	bwe
博物馆	bwg
备忘录	bwl
不为难	bwn
保温瓶	bwp
不完全	bwq
不行啊	bxa
不晓得	bxd
保险费	bxf
不喜欢	bxh
表现出	bxi
步行街	bxj
必修课	bxk
表现力	bxl
不信呢	bxn
保修期	bxq
保险丝	bxs
本系统	bxt
半小时	bxu
八仙桌	bxv
表现为	bxw
不要看	byk
比翼鸟	byn
编译器	byq
不一致	byv
不一样	byy
半自动	bzd
从不曾	cbc
从不会	cbh
擦边球	cbq
才不信	cbx
曾参与	ccy
从根本	cgb
词汇量	chl
才几个	cjg
催泪弹	cld
从哪里	cnl
擦屁股	cpg
猜中了	cvl
搓一搓	cyc
曾有过	cyg
催一下	cyx
打不过	dbg
都不会	dbh
大不了	dbl
但不能	dbn
都不怕	dbp
对不起	dbq
都不算	dbs
端到端	ddd
的地方	ddf
打电话	ddh
点点头	ddt
大多数	ddu
东道主	ddv
的东西	ddx
大动作	ddz
开发者	dev
豆腐块	dfk
答复你	dfn
答复他	dft
电风扇	dfu
答复我	dfw
大锅饭	dgf
打官司	dgs
待会儿	dhe
带回来	dhl
大家好	djh
对讲机	djj
多久了	djl
电吉他	djt
大舅子	djz
抵抗力	dkl
大块头	dkt
顶梁柱	dlv
都没了	dml
等你到	dnd
都能够	dng
电脑桌	dnv
对那些	dnx
的旁边	dpb
斗起来	dql
地球人	dqr
的确是	dqu
多去下	dqx
大企业	dqy
大清早	dqz
第三遍	dsb
第三方	dsf
电视剧	dsj
第三者	dsv
地头蛇	dtu
独特性	dtx
的时候	duh
当事人	dur
多少人	dur
的身上	duu
都是些	dux
大众化	dvh
呆住了	dvl
都这样	dvy
大制作	dvz
等我到	dwd
端午节	dwj
都完了	dwl
等问题	dwt
队伍中	dwv
等我下	dwx
定心丸	dxw
大意了	dyl
电影票	dyp
第一种	dyv
的样子	dyz
倒栽葱	dzc
对自己	dzj
都走了	dzl
动作片	dzp
大自然	dzr
打嘴仗	dzv
打字员	dzy
大动作	dzz
二把刀	ebd
而不是	ebu
二百五	ebw
二次元	ecy
二狗子	egz
二婚头	eht
二进制	ejv
二进制文件	ejw
饿了么	elm
俄罗斯	els
二流子	elz
耳旁风	epf
二维码	ewm
恶作剧	ezj
防波堤	fbd
烦不烦	fbf
分布式	fbu
复读机	fdj
发达了	fdl
放得下	fdx
分分钟	ffv
反过来	fgl
发红包	fhb
肺活量	fhl
防火墙	fhq
非常好	fih
放出来	fil
分开说	fku
菲律宾	flb
分量大	fld
翻了翻	flf
风凉话	flh
服了你	fln
分量小	flx
父母官	fmg
房门前	fmq
复明日	fmr
负能量	fnl
发请柬	fqj
飞起来	fql
废弃物	fqw
否认了	frl
发生的	fsd
烦死了	fsl
分散式	fsu
分散在	fsz
发帖子	ftz
放这吧	fvb
非主流	fvl
辅助码	fvm
反正是	fvu
辅助性	fvx
服务端	fwd
服务器	fwq
防污染	fwr
发完贴	fwt
风向标	fxb
放心了	fxl
方向盘	fxp
分析器	fxq
非线性	fxx
翻一翻	fyf
发言人	fyr
负责人	fzr
刚才的	gcd
搞错了	gcl
各层面	gcm
搞定了	gdl
管得着	gdv
鬼东西	gdx
干瞪眼	gdy
搞反了	gfl
股份制	gfv
高跟鞋	ggx
高个子	ggz
共和国	ghg
滚床单	gid
滚出来	gil
刚出去	giq
过程中	giv
刚开始	gku
过来了	gll
橄榄枝	glv
管理员	gly
搞明白	gmb
国民党	gmd
改明儿	gme
鬼门关	gmg
根目录	gml
干嘛呢	gmn
灌米汤	gmt
跟没说	gmu
高情商	gqu
过日子	grz
告诉你	gsn
光秃秃	gtt
狗腿子	gtz
过时了	gul
购物车	gwi
个性化	gxh
公信力	gxl
感谢你	gxn
感兴趣	gxq
更像是	gxu
共享下	gxx
雇佣兵	gyb
狗咬狗	gyg
工业化	gyh
够用了	gyl
更衣室	gyu
骨子里	gzl
工作上	gzu
工作者	gzv
还不到	hbd
会不会	hbh
回不来	hbl
很别扭	hbn
还不行	hbx
好多了	hdl
好多天	hdt
华尔街	hej
华尔兹	hez
回锅肉	hgr
回过头	hgt
花果山	hgu
还好吧	hhb
哈哈哈	hhh
还好了	hhl
还好听	hht
活化石	hhu
化合物	hhw
很吃力	hil
火车票	hip
缓冲区	hiq
还处于	hiy
很可观	hkg
很可能	hkn
很靠谱	hkp
很厉害	hlh
狐狸精	hlj
回来了	hll
行列式	hlu
合理性	hlx
还没动	hmd
还没好	hmh
护目镜	hmj
鸿门宴	hmy
后脑壳	hnk
会努力	hnl
海内外	hnw
害怕了	hpl
很奇怪	hqg
很庆幸	hqx
糊涂虫	hti
黄鼠狼	hul
活受罪	huz
号召力	hvl
红卫兵	hwb
好无聊	hwl
好习惯	hxg
还喜欢	hxh
候选窗	hxi
很辛苦	hxk
好想你	hxn
好心情	hxq
好心人	hxr
好像是	hxu
坏消息	hxx
坏心眼	hxy
黑匣子	hxz
还有个	hyg
好意思	hys
换一种	hyv
还以为	hyw
黑黝黝	hyy
还在吗	hzm
还早呢	hzn
孩子气	hzq
差不多	ibd
丑八怪	ibg
差不了	ibl
出不去	ibq
出版社	ibu
纯粹是	icu
称得上	idu
臭烘烘	ihh
喘口气	ikq
出来了	ill
吹牛皮	inp
秤盘子	ipz
充其量	iql
出气筒	iqt
传染病	irb
吃软饭	irf
传送门	ism
抽屉柜	itg
炊事班	iub
沉住气	ivq
称之为	ivw
唱完歌	iwg
成为了	iwl
插线板	ixb
出现时	ixu
初学者	ixv
穿小鞋	ixx
程序员	ixy
出现在	ixz
常言道	iyd
差一个	iyg
差异化	iyh
差远了	iyl
纯爷们	iym
出月子	iyz
创造者	izv
创造性	izx
基本功	jbg
决不会	jbh
绝不会	jbh
讲不出	jbi
几百块	jbk
解不了	jbl
就不能	jbn
就不去	jbq
绝不是	jbs
基本上	jbu
架不住	jbv
经不住	jbv
就不行	jbx
就不要	jby
仅次于	jcy
机顶盒	jdh
几点钟	jdv
解放军	jfj
解放了	jfl
就刚刚	jgg
加工厂	jgi
几个钱	jgq
几个人	jgr
见光死	jgs
贱骨头	jgt
紧箍咒	jgv
金龟婿	jgx
节骨眼	jgy
急坏了	jhl
几乎是	jhu
结婚照	jhv
计划性	jhx
就会有	jhy
简化字	jhz
精简版	jjb
就觉得	jjd
交际花	jjh
叫叫叫	jjj
加进去	jjq
究竟是	jju
佼佼者	jjv
拒绝我	jjw
积极性	jjx
寄快递	jkd
据可靠	jkk
经看了	jkl
极可能	jkn
教科书	jku
就可以	jky
俱乐部	jlb
角落里	jll
就离谱	jlp
经理人	jlr
军令状	jlv
几年前	jnq
卷铺盖	jpg
剪切板	jqb
机器人	jqr
加入了	jrl
进入了	jrl
就是个	jsg
计算机	jsj
就算了	jsl
计算器	jsq
就算是	jsu
剪贴板	jtb
嚼舌头	jut
精神头	jut
就知道	jvd
价值观	jvg
江浙沪	jvh
竞争力	jvl
就直说	jvu
急转弯	jvw
就这些	jvx
就这样	jvy
阶下囚	jxq
就做个	jzg
接走了	jzl
尽责任	jzr
看不出	kbi
看不起	kbq
看不透	kbt
可不是	kbu
哭鼻子	kbz
坑惨了	kcl
肯定让	kdr
开发版	kfb
空房间	kfj
开发者	kfv
看过了	kgl
开过去	kgq
客观性	kgx
嗑瓜子	kgz
客户端	khd
看出来	kil
快捷键	kjj
开了口	klk
空落落	kll
快乐水	klu
看了眼	kly
苦命的	kmd
开幕式	kmu
可能被	knb
可能都	knd
可能是	knu
可能有	kny
哭去吧	kqb
看情况	kqk
看起来	kql
苦肉计	krj
坑死了	ksl
口头禅	kti
跨世纪	kuj
口水战	kuv
看着吧	kvb
卡住了	kvl
开胃菜	kwc
快完了	kwl
开玩笑	kwx
科学家	kxj
扛下了	kxl
苦行僧	kxs
开夜车	kyi
看一看	kyk
可以了	kyl
可以说	kyu
看一下	kyx
看样子	kyz
看自己	kzj
卡在了	kzl
抠字眼	kzy
了不起	lbq
老不死	lbs
老地方	ldf
来电话	ldh
劳动力	ldl
脸对脸	ldl
劳动者	ldv
两分半	lfb
老父母	lfm
两分钱	lfq
驴肝肺	lgf
了过来	lgl
了过去	lgq
两个字	lgz
厉害了	lhl
老黄牛	lhn
拦路虎	llh
狼来了	lll
浏览器	llq
老年人	lnr
老婆本	lpb
连起来	lql
类似于	lsy
劳什子	lsz
立体感	ltg
两天后	lth
乱弹琴	ltq
立体图	ltt
立陶宛	ltw
老天爷	lty
领头羊	lty
撂挑子	ltz
临时性	lux
连珠炮	lvp
连续剧	lxj
两小时	lxu
另一个	lyg
老油条	lyt
老油子	lyz
买不到	mbd
没办法	mbf
明白了	mbl
没保障	mbv
没兵线	mbx
没得比	mdb
买得到	mdd
马大哈	mdh
马德里	mdl
买东西	mdx
没胆子	mdz
没反应	mfy
玫瑰花	mgh
每个人	mgr
马后炮	mhp
迷魂阵	mhv
马虎眼	mhy
每句话	mjh
没救了	mjl
没记住	mjv
没看够	mkg
摩洛哥	mlg
命令行	mlh
摸了摸	mlm
买路钱	mlq
免礼姓	mlx
没明白	mmb
摸摸头	mmt
明明是	mmu
明明在	mmz
没那个	mng
模拟器	mnq
满脑子	mnz
冒牌货	mph
马屁精	mpj
没钱了	mql
马前卒	mqz
魔然繁	mrf
猛如虎	mrh
魔然简	mrj
没人了	mrl
默认情况下	mrq
毛绒绒	mrr
默认值	mrv
慢热型	mrx
没死吧	msb
没事的	msd
没事干	msg
没时间	msj
莫斯科	msk
没事了	msl
马上来	msl
没什么	msm
貌似是	msu
马上做	msz
没通过	mtg
迷魂汤	mth
满堂红	mth
买糖吃	mti
没事吧	mub
没事儿	mue
明知道	mvd
没这个	mvg
买这些	mvx
门外汉	mwh
没忘记	mwj
没问题	mwt
没学会	mxh
没悬念	mxn
每星期	mxq
莫须有	mxy
每一份	myf
每一个	myg
磨洋工	myg
沐浴露	myl
免疫力	myl
没眼力	myl
慢一拍	myp
牧羊犬	myq
每一天	myt
每一种	myv
每一位	myw
每一项	myx
满足了	mzl
美滋滋	mzz
你爱我	naw
拿不动	nbd
诺贝尔	nbe
那不会	nbh
那不成	nbi
能不能	nbn
你不信	nbx
难得的	ndd
那倒是	ndu
你逗我	ndw
南瓜饼	ngb
你干嘛	ngm
那个人	ngr
能告诉	ngs
那还好	nhh
拿回来	nhl
男孩子	nhz
农产品	nip
哪几个	njg
那家伙	njh
牛角尖	njj
凝聚力	njl
娘家人	njr
哪几种	njv
诺基亚	njy
那可是	nks
奴隶制	nlv
那么办	nmb
那么高	nmg
那么久	nmj
你们俩	nml
你牛逼	nnb
你陪我	npw
女朋友	npy
男朋友	npy
年轻的	nqd
拿起来	nql
年轻人	nqr
年轻时	nqu
你认为	nrw
哪条街	ntj
你说的	nud
那时候	nuh
闹着玩	nvw
那阵子	nvz
你无情	nwq
那些话	nxh
哪些人	nxr
哪一个	nyg
农业局	nyj
哪一类	nyl
哪一天	nyt
那也是	nyu
哪一种	nyv
暖洋洋	nyy
男子汉	nzh
脑子里	nzl
农作物	nzw
哦哦哦	ooo
跑不过	pbg
跑不了	pbl
怕不是	pbu
平底锅	pdg
跑掉了	pdl
配得上	pdu
碰钉子	pdz
跑过来	pgl
跑过去	pgq
排行榜	phb
批处理	pil
跑江湖	pjh
破烂货	plh
拼了命	plm
泼冷水	plu
贫民窟	pmk
拍马屁	pmp
骗你的	pnd
泡女人	pnr
跑起来	pql
怕死鬼	psg
凭什么	psm
骗他的	ptd
破天荒	pth
配套件	ptj
盘山路	pul
配置表	pvb
骗我的	pwd
拍相片	pxp
亲爱的	qad
敲边鼓	qbg
前不久	qbj
起不来	qbl
去不去	qbq
千比特	qbt
却不是	qbu
强多了	qdl
确定性	qdx
签发人	qfr
全方位	qfw
穷光蛋	qgd
全家福	qjf
前几年	qjn
全家人	qjr
情景时	qju
气哭了	qkl
情况下	qkx
起来嗨	qlh
起来了	qll
瞧了瞧	qlq
群聊天	qlt
请联系	qlx
千里眼	qly
去送吧	qsb
请稍等	qsd
穷死了	qsl
敲竹杠	qvg
穷折腾	qvt
牵着手	qvu
翘尾巴	qwb
取下了	qxl
趋向于	qxy
清一色	qys
前一天	qyt
窃以为	qyw
起源自	qyz
全自动	qzd
去做了	qzl
若不是	rbu
忍不住	rbv
人聪明	rcm
不入耳	bre
寄存器	reg
人贩子	rfz
如果到	rgd
软骨头	rgt
如何了	rhl
任何人	rhr
人家的	rjd
扔进去	rjq
燃料费	rlf
人民币	rmb
人们的	rmd
人跑了	rpl
肉起来	rql
热水壶	ruh
热心肠	rxi
扔下去	rxq
人与人	ryr
人走了	rzl
孺子牛	rzn
算不了	sbl
塞不下	sbx
三次元	scy
苏打水	sdu
所导致	sdv
伺服器	sfq
三分钟	sfv
撒个娇	sgj
三个人	sgr
三个月	sgy
随机本	sjb
三角带	sjd
三鞠躬	sjg
三角形	sjx
塑料袋	sld
三轮车	sli
什么啊	sma
什么词	smc
什么的	smd
什么鬼	smg
什么叫	smj
什么人	smr
什么是	smu
丧门星	smx
什么样	smy
死脑筋	snj
三千丈	sqv
虽然是	sru
三人行	srx
说说看	ssk
所谓的	swd
三位数	swu
死心了	sxl
死心眼	sxy
所有的	syd
所以能	syn
所有人	syr
啥意思	sys
所有值	syv
私以为	syw
撒子嘛	szm
听不到	tbd
逃不出	tbi
听不出	tbi
听不清	tbq
痛不痛	tbt
听不听	tbt
谈不上	tbu
停不下	tbx
太菜了	tcl
挺逗的	tdd
特等奖	tdj
太多了	tdl
天底下	tdx
土耳其	teq
托付给	tfg
铁饭碗	tfw
铁公鸡	tgj
太贵了	tgl
挺过去	tgq
听故事	tgu
太好了	thl
跳出来	til
套接字	tjz
太困了	tkl
太可怕	tkp
叹口气	tkq
停了停	tlt
挑毛病	tmb
太忙了	tml
太牛逼	tnb
太难了	tnl
太牛了	tnl
听腻了	tnl
太难为	tnw
通气孔	tqk
太强了	tql
汰漒𣱾	tql
钛镪钌	tql
抬起头	tqt
他认为	trw
她认为	trw
替死鬼	tsg
通通电	ttd
听听看	ttk
透透气	ttq
团团转	ttv
图书馆	tug
太帅了	tul
调试器	tuq
太直接	tvj
偷着乐	tvl
统治者	tvv
剃须刀	txd
同性恋	txl
拖下去	txq
退一步	tyb
图一乐	tyl
拖油瓶	typ
替罪羊	tzy
说不定	ubd
说不出	ubi
说白了	ubl
傻白甜	ubt
是不是	ubu
时不时	ubu
睡不醒	ubx
水电费	udf
说大话	udh
水电局	udj
受得了	udl
书呆子	udz
十二年	uen
十二三	ues
十分钟	ufv
手工活	ugh
受够了	ugl
生活费	uhf
说好了	uhl
耍花腔	uhq
耍花招	uhv
十几个	ujg
数据库	ujk
睡觉了	ujl
实际上	uju
手机上	uju
上进心	ujx
顺口气	ukq
手榴弹	uld
上来了	ull
耍流氓	ulm
试了试	ulu
是没错	umc
审美观	umg
什么话	umh
双面胶	umj
生命力	uml
睡美人	umr
说明书	umu
石墨烯	umx
是没有	umy
神农架	unj
上哪去	unq
生僻字	upz
说起来	uql
沙琪玛	uqm
上千年	uqn
神枪手	uqu
输入法	urf
伤人心	urx
是什么	usm
十三年	usn
事实上	usu
石头杯	utb
晒太阳	uty
试试看	uuk
少数派	uup
上上签	uuq
睡着了	uvl
少壮派	uvp
水蒸气	uvq
实质性	uvx
上万个	uwg
十五号	uwh
睡午觉	uwj
耍无赖	uwl
爽歪歪	uww
手写板	uxb
鼠须管	uxg
说下去	uxq
陕西省	uxu
上下文	uxw
耍心眼	uxy
试用版	uyb
上一个	uyg
十一年	uyn
试用期	uyq
试一试	uyu
试一下	uyx
十字镐	uzg
十字弩	uzn
实在是	uzu
猪啊你	van
只不过	vbg
真不会	vbh
转不了	vbl
这才敢	vcg
这都被	vdb
招待会	vdh
战斗力	vdl
真的是	vds
支付宝	vfb
脂肪肝	vfg
正方形	vfx
诸葛亮	vgl
这个人	vgr
涨工资	vgz
真好看	vhk
真会算	vhs
正好在	vhz
支持率	vil
这几天	vjt
这几种	vjv
逐客令	vkl
这可是	vku
纸老虎	vlh
重量级	vlj
这么菜	vmc
这么惨	vmc
殖民地	vmd
这么怪	vmg
这么坏	vmh
这么丑	vmi
这么久	vmj
这么卡	vmk
这么懒	vml
这么溜	vml
这么牛	vmn
这么穷	vmq
这么巧	vmq
这貌似	vms
这么少	vmu
正面照	vmv
这么想	vmx
这么有	vmy
智能化	vnh
这你就	vnj
正能量	vnl
中年人	vnr
只能说	vnu
只能有	vny
站起来	vql
转圈圈	vqq
竹蜻蜓	vqt
主人家	vrj
这挺好	vth
整条街	vtj
主题曲	vtq
真正的	vvd
这种话	vvh
找找看	vvk
这阵子	vvz
爪哇岛	vwd
中午好	vwh
赚外快	vwk
植物人	vwr
遮羞布	vxb
主心骨	vxg
这些话	vxh
执行率	vxl
这些人	vxr
直辖市	vxu
只需要	vxy
直性子	vxz
这样的	vyd
这有个	vyg
专业户	vyh
照妖镜	vyj
这样看	vyk
这样了	vyl
这一年	vyn
这意思	vys
这也是	vyu
志愿者	vyv
只因为	vyw
这也行	vyx
占有欲	vyy
重灾区	vzq
我不会	wbh
玩不来	wbl
未必是	wbu
我不信	wbx
我不用	wby
歪脖子	wbz
五点半	wdb
无底洞	wdd
我掉了	wdl
伪代码	wdm
我带你	wdn
我的天	wdt
五分钟	wfv
问过了	wgl
亡国奴	wgn
外国人	wgr
外行人	whr
万花筒	wht
文件夹	wjj
忘记了	wjl
乌克兰	wkl
无理码	wlm
无厘头	wlt
物联网	wlw
无论在	wlz
我们的	wmd
我没进	wmj
未命名	wmm
我们能	wmn
我貌似	wms
我没事	wmu
无名指	wmv
我们在	wmz
窝囊废	wnf
忘年交	wnj
玩腻了	wnl
挖墙脚	wqj
我认为	wrw
为什么	wsm
我是谁	wss
无所谓	wsw
我他妈	wtm
问题是	wtu
晚上好	wuh
维生素	wus
无止境	wvj
捂着头	wvt
文绉绉	wvv
玩玩看	wwk
崴星人	wxr
晚一步	wyb
委员会	wyh
玩一局	wyj
我也是	wyu
误以为	wyw
闻一下	wyx
乌鸦嘴	wyz
屋子里	wzl
想不到	xbd
修不好	xbh
相比较	xbj
想不开	xbk
学不来	xbl
新标签	xbq
下半身	xbu
行不行	xbx
西餐厅	xct
修订版	xdb
现代版	xdb
想多了	xdl
想当年	xdn
行得通	xdt
小动作	xdz
消防队	xfd
笑翻了	xfl
小哥哥	xgg
醒过来	xgl
想过没	xgm
想跟你	xgn
性格上	xgu
小伙伴	xhb
小孩儿	xhe
想好了	xhl
下回去	xhq
小红书	xhu
歇后语	xhy
小伙子	xhz
性价比	xjb
小姐姐	xjj
戏剧性	xjx
先看看	xkk
辛苦了	xkl
性冷淡	xld
小狼毫	xlh
下来了	xll
心理学	xlx
叙利亚	xly
小企鹅	xqe
想起来	xql
笑死了	xsl
些什么	xsm
想通了	xtl
消失在	xuz
县政府	xvf
瞎折腾	xvt
线装书	xvu
想这些	xvx
掀桌子	xvz
想歪了	xwl
谢谢你	xxn
下一个	xyg
吸引力	xyl
小意思	xys
小姨子	xyz
现在不	xzb
现在的	xzd
现在看	xzk
选择了	xzl
现在能	xzn
现在是	xzu
现在有	xzy
现在在	xzz
一遍遍	ybb
也不太	ybt
用不完	ybw
也不晚	ybw
一次次	ycc
一次的	ycd
原材料	ycl
一次性	ycx
一定把	ydb
一点点	ydd
有点二	yde
羊癫疯	ydf
有代沟	ydg
一定会	ydh
一大截	ydj
一大块	ydk
有道理	ydl
源代码	ydm
一定能	ydn
一刀切	ydq
有的人	ydr
一定是	ydu
源地址	ydv
有点像	ydx
运动员	ydy
一袋子	ydz
幺蛾子	yez
一方面	yfm
要分清	yfq
语法树	yfu
一分钟	yfv
运费险	yfx
一个个	ygg
一个劲	ygj
一根筋	ygj
英格兰	ygl
应该能	ygn
一个人	ygr
硬骨头	ygt
应该是	ygu
应该问	ygw
有关系	ygx
一个月	ygy
一个字	ygz
银行卡	yhk
一回来	yhl
一会再	yhz
亚克力	ykl
一览表	ylb
伊利丹	yld
一两个	ylg
油老虎	ylh
要来了	yll
赢了吗	ylm
一路上	ylu
言论中	ylv
越来越	yly
愈来愈	yly
原来在	ylz
有毛病	ymb
幽默感	ymg
一麻溜	yml
有没有	ymy
要求高	yqg
一起来	yql
有钱人	yqr
摇钱树	yqu
一千五	yqw
一起想	yqx
一起向	yqx
一起做	yqz
有什么	ysm
压岁钱	ysq
英特尔	yte
以太坊	ytf
一条龙	ytl
也知道	yvd
一指禅	yvi
意中人	yvr
易中天	yvt
也只是	yvu
一致性	yvx
以至于	yvy
以致于	yvy
英伟达	ywd
一窝蜂	ywf
圆舞曲	ywq
以为是	ywu
意味着	ywv
一小撮	yxc
一小段	yxd
有效果	yxg
一小会	yxh
优先级	yxj
有效期	yxq
有些人	yxr
一小时	yxu
一下子	yxz
压压惊	yyj
游泳圈	yyq
一言堂	yyt
园子里	yzl
做不到	zbd
做不好	zbh
再不济	zbj
走不开	zbk
走不了	zbl
再不行	zbx
在不在	zbz
坐地板	zdb
知道的	zdd
自动化	zdh
走丢了	zdl
死对头	zdt
这倒是	zdu
在逗我	zdw
总担心	zdx
自定义	zdy
字符串	zfi
走过场	zgi
走过来	zgl
在干嘛	zgm
走过去	zgq
最感人	zgr
自顾自	zgz
藏红花	zhh
最好看	zhk
做好了	zhl
走后门	zhm
再回头	zht
咋回事	zhu
最好笑	zhx
自己的	zjd
自己干	zjg
总经理	zjl
早几年	zjn
这就是	zjs
这件事	zjs
自觉性	zjx
自驾游	zjy
再联系	zlx
坐落于	zly
坐落在	zlz
怎么办	zmb
怎么才	zmc
走马灯	zmd
怎么关	zmg
怎么会	zmh
怎么讲	zmj
怎么了	zml
做买卖	zmm
怎么能	zmn
自贸区	zmq
怎么送	zms
怎么说	zmu
怎么着	zmv
怎么行	zmx
怎么样	zmy
怎么做	zmz
在哪里	znl
在哪呢	znn
组起来	zql
最全面	zqm
自然会	zrh
自然码	zrm
自认为	zrw
责任心	zrx
座谈会	zth
走天下	ztx
座上宾	zub
早说了	zul
早知道	zvd
在这个	zvg
子账号	zvh
增长率	zvl
在这里	zvl
在这呢	zvn
走着瞧	zvq
自行车	zxi
坐下来	zxl
走下去	zxq
再也不	zyb
在一次	zyc
怎样的	zyd
做一个	zyg
座右铭	zym
总以为	zyw
做一些	zyx
做一下	zyx
作用域	zyy
撮一撮	zyz
坐在那	zzn
自尊心	zzx
再怎样	zzy
莫过于	mgy
